111111111111111111
1E0000000000000001
101001000000010101
101001000000010101
1000CCCCCCC0000PC1
111111111111111111