111111111111111111
1E0000000000000001
101001000000010101
10100100P000010101
1000CCCCCCC00P00C1
111111111111111111